R 800800

NO sprites/Wall_North.png
SO sprites/Wall_South.png
WE sprites/Wall_West.png
EA sprites/Wall_East.png




F 0,200,100
C 0,100,200


1111111111
1000000001
1000000001
1000000001
1000000001
1000N00001
1000000001
1000000001
1000000001
1000000001
1000000001
1111111111
