


NO ./path_to_the_north_texture



SO ./path_to_the_south_texture



WE ./path_to_the_west_texture



EA ./path_to_the_east_texture

F 220,100,0
C 225,30,0

111111111111
11S000000001
100010000001
100001000001
101000000011
111111111111

