


NO ./path_to_the_north_texture



SO ./path_to_the_south_texture



WE ./path_to_the_west_texture



EA ./path_to_the_east_texture

F 220,100,0
C 225,30,0

11111111111111
10000000000001
10000000000001
10000010000001
10000000000001
10011110000001
1010S001000001
10000000000001
10000000000001
10000000000001111111
10000110000000000001
10000110000000000001
10000000000001111111
10000000000001
11111111111111

