


NO ./path_to_the_north_texture



SO ./path_to_the_south_texture



WE ./path_to_the_west_texture



EA ./path_to_the_east_texture

F 220,100,0
C 225,30,0



1111111111111111111111111111111111111111111
1N000000000000011
10000000010000111
10000000000001111
11111111111101111
11111111111101111
111111101 110111
11111111111111111
