
EA ./textures/Wall_East.png			    
NO ./textures/Wall_North.png
SO ./textures/Wall_South.png
WE ./textures/Wall_West.png

F 220,111,119
C 225,111,200

 11111111111111111111111111111111111111
            1000000000000000000000000001
1000000000000000000000000000000000000001
1000000000000000000000000000000000000001
1000000000000000000000000000000000000001
1000000000000000001010000000000000000001
1000000000000000001010000000000000000001
1000000000000000001010010000000000000001
1000000000000000001110010000000000000001
1000000000000000000000000000000000000001
10000000000000000000S0000000000000000001
1000000000000000000000000000000000000001
1000000000000000000000000011111111111111
10000000000000000000000001                               
 11111111111111111111111111111111111111