EA ./textures/Wall_East.png			    
NO ./textures/Wall_North.png
SO ./textures/Wall_South.png
WE ./textures/Wall_West.png

F 255,0,0

C 255,205,255



11111111111111111111
10000000000000000001
10000000000000000001
10000000000000000001   1
10000000000000000001  101
10000000000000000001   1
1000000000N000000001
10000000000000000001
10000000000000000001
10000000000000000001
10000001000001000001
11111111111111111111