



EA			   ./textures/texture1.xpm




NO   ./textures/texture2.xpm


SO			./textures/texture3.xpm


WE	./textures/texture4.xpm

F   0,0,0

C	  255,255,255






1111111111
1000000001
10N0000001
1000000001
1111111111