NO ./textures/texture1.xpm
SO ./textures/texture2.xpm
WE ./textures/texture3.xpm
EA ./textures/texture4.xpm
F 139, 140, 198
C 101, 210, 93

111111111111111111111111111111111111111111111111111111111111111111111111111111111111111111111111111111111111111111111111111111111111111111111111111111
110000000000000100001000001000111100010010010001101000110001000110010100010000110110101111011000000000111000000011000110011100010000100000010000000011
100010001000011010000101000100111000011100100000000000000110100100000000010000000100010000101001010100011000010000101001100000100010011100010000001001
110000110000101010100000000001001001000100010000000011100101000000000100000000010000000100100000010000010000011000010000001100111000000100101000001101
101000000111100000000000000000000101000110010011000101110101000000000000000000001100010000100000100100100011000000001010000000010000000110000100010001
110000001000100100000100000010101101101010001000000000001001011000001010101010000010000000001000000111001100100000110001001001000011000000000101001001
100000100000101100101000100101010011000100010000010000000001100101001010000010000000000011000100011100000101100000100110010100100010001001001000010101
110000000000011001100100000001010100000000101010000000010000100000000000011001010000100100010001000000000000010110000100111011010000100000110011100011
110111010100000110000001010001000000100100000001000001010110001100000000000010100000001000100001111000011010000010111000111100010100100011010011101001
100000110010101001000101000000001101000000110000100100010010010000010101101110100001100001001001110110011000001010010001000011100000100011100000010011
110001000000000000100100000001101000010100100000110000000100000101010101000000001000000111000000010100001100001001101010101101011110010000110010110001
100000111011000100000011011100010110110000100000011101001010000000100100111010100000011001000001001E00010001101011110001001100010100000000000001001111
100001101001010100000000000100011100000000000010100000110100101000010000010000010001000010100100010010100000110110000000000011000000001000100001010001
100000000000000000001000000001001000000011010100001110001100000000110001100000000011001010000011000010000000000001010000110110000101000110111110101101
100010000000001001110001010000001000101000010000000000100100000100101001101100111010100000111010001010100010100111101000100000010000010010010011100011
100000000000010111000100011001010001000000101000101000000101000000101001000011011000010011000001010001000111001101100000010100010000001001101000010111
101010000001000010100011001010010001111000010110010100110001000111101001001001101000100100100010100101101010N00000101001000001001000010101011000111001
110000010000000000000010000011001000111100100010010000000010000010100001000100010010001000000100010110000000001001000001100100000101100110000011001101
101010001001001101100001100101010010000001010000010000101000100001000000100010010100001010001010100000000100000110000001001000000101001000001001000001
101001001000000000000000000001100000001000000100010010000110010100100010001001101010111000011100010100000000010100010100000101000011010001010101011101
100001001000001000101000010001000001000000000100000100001000000000000000000101100001010001000100000000101100000001001010001010011001011001000010100001
100011001001100100010010000010000000000000011000000001011000000010000011010000000100111010100100001000011100110000010001011101111100000100100000100101
101001000000010000110000000001000001011010001110101010001000010011010110100010000000000001100000001000100010001101000001100000100001101010011000000001
110001000001010001000000010100000010001000011000111000000100000110100010000000011001000000000010000000110011001001000100010100001011000101100100000001
110001000001010001010000000000001100101000010000010000010000000000110000010000001110001100000001100000001001001001101011000100000010011000000111011001
101101000000000000100001000110000100000000011000111000001101001100100001000000010001011010101001001000101000010000001001010010000001000100000000000001
100100001010000000000000000000110100100000110100001100100011000110011101111000001010110001000000100000010000011100110001010000000000011100010000000001
100011000010010100001010000101000010000010000000000000110000000011010001010011101101100011000000011101000001001100010001010001001000000000000000000111
110011000010001000010010011000100101001000100000010000010011000000001000000010100100001000111110110110110001100101110010001001001001000000100100000001
100001010001000000001010001000100010000010001000100010000001100100010000001001010000000000101100001001010000000000100111001000000000001011000100000001
100000001000010100000100011001100001100110011110010001001000000101000100001000000100111100000000000100001100000011100110100100100101000000100001000101
111111111111111111111111111111111111111111111111111111111111111111111111111111111111111111111111111111111111111111111111111111111111111111111111111111
