EA ./textures/Wall_East.png			    
NO ./textures/Wall_North.png
SO ./textures/Wall_South.png
WE ./textures/Wall_West.png

F 50,222,120

C 255,205,255



11111111111111111111
10000000000000000001
10000000000000000001
10000000000000000001
10000000000000000001
10000000001000000001
1000000000N000000001
10000000000000000001
10000000000000000001
10000000000000000001
10000000000000000001
11111111111111111111