EA ./textures/Wall_East.png			    
NO ./textures/Wall_North.png
SO ./textures/Wall_South.png
WE ./textures/Wall_West.png
F 139,140,198
C 101,210,93

        1111111111111111111111111
        1000000000110000000000001
        1011000001110000000000001
        100100000000000000000000111
11111111101011000001110000000000001
10000000001100000111011111011101111
10111110111111111000000000010001
10111110111111111011101010010001  111
10111000000110101011100000010001  10
1011000N100000000001100000010001  111
10110000000000000001101010010001
10111000001110101011111011110001
10111110111 1110101 100000000001
10111111111111111111111111111011
10000000000000000000000000000001
11111111111111111111111111111111
