NO ./textures/texture1.xpm
SO ./textures/texture2.xpm
WE ./textures/texture3.xpm
EA ./textures/texture4.xpm
F 139, 140, 198
C 101, 210, 93

        1111111111111111111111111
        1000000000110000000000001
        1011000001110000000000001
        1001000000000000000000001
111111111110110000011100000000001
100000000001100000111011110111111
101111101111111110111000000100011
10111110111111111011101010010001
10111000000110101011100000010001
1011000N100000000001100000010001
10110000000000000001101010010001
10111000001110101011111011110001
10111110111 1110101 1011101101
100000000000000000000000000001
111111111111111111111111111111
